100  -1  -1  -1  -1  -1  -1  -1  -1  -1  -1  -1  -1  -1  -1  -1  -1  -1  -1  -1    -1  -1  -1  -1  -1  -1  -1  -1  -1  -1  -1  -1  -1  -1  -1  -1  -1  -1  -1  -1    -1  -1  -1  -1  -1  -1  -1  -1  -1  -1  -1  -1  -1  -1  -1  -1  -1  -1  -1  -1    -1  -1  -1  -1  -1  -1  -1  -1  -1  -1  -1  -1  -1  -1  -1  -1  -1  -1  -1  -1    -1  -1  -1  -1  -1  -1  -1  -1  -1  -1  -1  -1  -1  -1  -1  -1  -1  -1  -1 100
100 100 100 100 100 100 100 100 100 100 100 100 100 100 100 100 100 100 100 100   100 100 100 100 100 100 100 100 100 100 100 100 100 100 100 100 100 100 100 100   100 100 100 100 100 100 100 100 100 100 100 100 100 100 100 100 100 100 100 100   100 100 100 100 100 100 100 100 100 100 100 100 100 100 100 100 100 100 100 100   100 100 100 100 100 100 100 100 100 100 100 100 100 100 100 100 100 100 100 100
100 100 100 100 100 100 100 100 100 100 100 100 100 100 100 100 100 100 100 100   100 100 100 100 100 100 100 100 100 100 100 100 100 100 100 100 100 100 100 100   100 100 100 100 100 100 100 100 100 100 100 100 100 100 100 100 100 100 100 100   100 100 100 100 100 100 100 100 100 100 100 100 100 100 100 100 100 100 100 100   100 100 100 100 100 100 100 100 100 100 100 100 100 100 100 100 100 100 100 100
100 100 100 100 100 100 100 100 100 100 100 100 100 100 100 100 100 100 100 100   100 100 100 100 100 100 100 100 100 100 100 100 100 100 100 100 100 100 100 100   100 100 100 100 100 100 100 100 100 100 100 100 100 100 100 100 100 100 100 100   100 100 100 100 100 100 100 100 100 100 100 100 100 100 100 100 100 100 100 100   100 100 100 100 100 100 100 100 100 100 100 100 100 100 100 100 100 100 100 100
100 100 100 100 100 100 100 100 100 100 100 100 100 100 100 100 100 100 100 100   100 100 100 100 100 100 100 100 100 100 100 100 100 100 100 100 100 100 100 100   100 100 100 100 100 100 100 100 100 100 100 100 100 100 100 100 100 100 100 100   100 100 100 100 100 100 100 100 100 100 100 100 100 100 100 100 100 100 100 100   100 100 100 100 100 100 100 100 100 100 100 100 100 100 100 100 100 100 100 100
100 100 100 100 100 100 100 100 100 100 100 100 100 100 100 100 100 100 100 100   100 100 100 100 100 100 100 100 100 100 100 100 100 100 100 100 100 100 100 100   100 100 100 100 100 100 100 100 100 100 100 100 100 100 100 100 100 100 100 100   100 100 100 100 100 100 100 100 100 100 100 100 100 100 100 100 100 100 100 100   100 100 100 100 100 100 100 100 100 100 100 100 100 100 100 100 100 100 100 100


3  0  0  0  0  0  0  0  0  0  0  0  0  0  0  0  0  0  0  0     0  0  0  0  0  0  0  0  0  0  0  0  0  0  0  0  0  0  0  0     0  0  0  0  0  0  0  0  0  0  0  0  0  0  0  0  0  0  0  0    0   0  0  0  0  0  0  0  0  0  0  0  0  0  0  0  0  0  0  0     0  0  0  0  0  0  0  0  0  0  0  0  0  0  0  0  0  0  0  0
2  8 12 16 20 -1 -1 24 28 32 36  2 -1  7  6 -1  0  0  0 -1     8 12 16 20 24 28 32 36 -1  8 12 16 20 -1 -1  0 -1  0 -1  0    24 28 32 36  8 12 16 20 24 28 32 36  2 -1  7  6 -1  8 12 16    20 -1  0  0  0 -1 -1 -1 -1 24 28 32 36  8 12 16 20 -1 24 28    32 36 -1 -1 -1  0  0  0  0 -1 -1 -1 -1 -1 41 45 49 53 -1 -1
2  9 13 17 21 -1 -1 25 29 33 37 -1 -1  7  6 -1 -1  0 -1 -1     9 13 17 21 25 29 33 37 -1  9 13 17 21 -1 -1 -1 -1 -1 -1 -1    25 29 33 37  9 13 17 21 25 29 33 37 -1 -1  7  6 -1  9 13 17    21 -1 -1  0 -1 -1 -1 -1 -1 25 29 33 37  9 13 17 21 -1 25 29    33 37 -1  0  0 -1 -1 -1 -1  0  0 -1 -1 -1 42 46 50 54 -1 -1
2 10 14 18 22 61 64 26 30 34 38 -1 -1  7  6 -1 -1 -1 -1 64    10 14 18 22 26 30 34 38 -1 10 14 18 22 -1 -1 -1  0 -1 -1 -1    26 30 34 38 10 14 18 22 26 30 34 38 -1 -1  7  6 -1 10 14 18    22 -1 -1 -1 -1 -1  0 -1 -1 26 30 34 38 10 14 18 23 -1 26 30    34 38 -1 -1 -1 -1  0  0 -1 -1 -1 -1 -1 -1 -1 47 51 55 54 -1
2 11 15 19 23 62 65 27 31 35 39  2 -1  7  6 -1 -1 -1 -1 65    11 15 19 23 27 31 35 39 -1 11 15 19 23 -1 -1  0  0  0 -1  0    27 31 35 39 11 15 19 23 27 31 35 39  2 -1  7  6 -1 11 15 19    23 -1 -1  0  0  0  0  0 -1 27 31 35 39 11 15 19 23 -1 27 31    35 39 -1  0  0  0  0  0  0  0  0 -1 -1 -1 -1 48 52 56 -1 -1
1  0  0  0  0  0  0  0  0  0  0  0  0  5  4  0  0  0  0  0     0  0  0  0  0  0  0  0  0  0  0  0  0  0  0  0  0  0  0  0     0  0  0  0  0  0  0  0  0  0  0  0  0  0  5  4  0  0  0  0     0  0  0  0  0  0  0  0  0  0  0  0  0  0  0  0  0  0  0  0     0  0  0  0  0  0  0  0  0  0  0  0  0  0  0  0  0  0  0  0

-1 -1 -1 -1 -1 -1 -1 -1 -1 -1 -1 -1 -1 -1 -1 -1 -1 -1 -1 -1    -1 -1 -1 -1 -1 -1 -1 -1 -1 -1 -1 -1 -1 -1 -1 -1 -1 -1 -1 -1   -1 -1 -1 -1 -1 -1 -1 -1 -1 -1 -1 -1 -1 -1 -1 -1 -1 -1 -1 -1    -1 -1 -1 -1 -1 -1 -1 -1 -1 -1 -1 -1 -1 -1 -1 -1 -1 -1 -1 -1    -1 -1 -1 -1 -1 -1 -1 -1 -1 -1 -1 -1 -1 -1 -1 -1 -1 -1 -1 -1
-1 -1 -1 -1 -1 -1 -1 -1 -1 -1 -1 59 -1 -1 -1 -1 -1 59 -1 -1    -1 -1 -1 -1 -1 -1 -1 -1 -1 -1 -1 -1 -1 -1 -1 59 -1 59 -1 59   -1 -1 -1 -1 -1 -1 -1 -1 -1 -1 -1 -1 59 -1 -1 -1 -1 -1 -1 -1    -1 -1 -1 59 -1 -1 -1 -1 -1 -1 -1 -1 -1 -1 -1 -1 -1 -1 -1 -1    -1 -1 -1 -1 59 -1 -1 -1 -1 59 -1 -1 -1 -1 -1 -1 -1 -1 -1 -1
59 -1 -1 -1 -1 -1 -1 -1 -1 -1 -1 60 -1 -1 -1 -1 -1 60 -1 -1    -1 -1 -1 -1 -1 -1 -1 -1 -1 -1 -1 -1 -1 -1 -1 60 -1 60 -1 60   -1 -1 -1 -1 -1 -1 -1 -1 -1 -1 -1 -1 60 -1 -1 -1 -1 -1 -1 -1    -1 -1 -1 60 -1 -1 -1 -1 -1 -1 -1 -1 -1 -1 -1 -1 -1 -1 -1 -1    -1 -1 -1 -1 60 -1 -1 -1 -1 60 -1 -1 -1 -1 -1 -1 -1 -1 -1 -1
60 -1 -1 -1 63 -1 -1 -1 -1 -1 -1 59 -1 -1 -1 -1 -1 -1 -1 -1    -1 -1 -1 -1 -1 -1 -1 -1 -1 -1 -1 -1 -1 -1 -1 -1 -1 -1 -1 -1   -1 -1 -1 -1 -1 -1 -1 -1 -1 -1 -1 -1 59 -1 -1 -1 -1 -1 -1 -1    -1 -1 -1 -1 -1 -1 59 -1 -1 -1 -1 -1 -1 -1 -1 -1 -1 -1 -1 -1    -1 -1 -1 -1 -1 -1 -1 -1 -1 -1 -1 -1 -1 -1 -1 -1 -1 -1 -1 -1
-1 -1 -1 -1 -1 -1 -1 -1 -1 -1 -1 60 -1 -1 -1 -1 -1 -1 -1 -1    -1 -1 -1 -1 -1 -1 -1 -1 57 -1 -1 -1 -1 -1 -1 -1 -1 -1 58 -1   -1 -1 -1 -1 -1 -1 -1 -1 -1 -1 -1 -1 60 -1 -1 -1 -1 -1 -1 -1    -1 -1 -1 -1 -1 -1 60 -1 -1 -1 -1 -1 58 -1 -1 -1 -1 -1 -1 -1    -1 -1 -1 -1 -1 -1 -1 -1 -1 -1 -1 -1 58 -1 -1 47 51 55 55 54
-1 -1 -1 -1 -1 -1 -1 -1 -1 -1 -1 -1 -1 -1 -1 -1 -1 -1 -1 -1    -1 -1 -1 -1 -1 -1 -1 -1 -1 -1 -1 -1 -1 -1 -1 -1 -1 -1 -1 -1   -1 -1 -1 -1 -1 -1 -1 -1 -1 -1 -1 -1 -1 -1 -1 -1 -1 -1 -1 -1    -1 -1 -1 -1 -1 -1 -1 -1 -1 -1 -1 -1 -1 -1 -1 -1 -1 -1 -1 -1    -1 -1 -1 -1 -1 -1 -1 -1 -1 -1 -1 -1 -1 -1 -1 -1 -1 -1 -1 -1

-1 -1 -1 -1 -1 -1 -1 -1 -1 -1 -1 -1 -1 -1 -1 -1 -1 -1 -1 -1    -1 -1 -1 -1 -1 -1 -1 -1 -1 -1 -1 -1 -1 -1 -1 -1 -1 -1 -1 -1   -1 -1 -1 -1 -1 -1 -1 -1 -1 -1 -1 -1 -1 -1 -1 -1 -1 -1 -1 -1    -1 -1 -1 -1 -1 -1 -1 -1 -1 -1 -1 -1 -1 -1 -1 -1 -1 -1 -1 -1    -1 -1 -1 -1 -1 -1 -1 -1 -1 -1 -1 -1 -1 -1 -1 -1 -1 -1 -1 -1
-1 -1 -1 -1 -1 -1 -1 -1 -1 -1 -1 -1 -1 -1 -1 -1 -1 -1 -1 -1    -1 -1 -1 -1 -1 -1 -1 -1 -1 -1 -1 -1 -1 -1 -1 -1 -1 -1 -1 -1   -1 -1 -1 -1 -1 -1 -1 -1 -1 -1 -1 -1 -1 -1 -1 -1 -1 -1 -1 -1    -1 -1 -1 -1 -1 -1 -1 -1 -1 -1 -1 -1 -1 -1 -1 -1 -1 -1 -1 -1    -1 -1 -1 -1 -1 -1 -1 -1 -1 -1 -1 -1 -1 -1 -1 -1 -1 -1 -1 -1
-1 -1 -1 -1 -1 -1 -1 -1 -1 -1 -1 -1 -1 -1 -1 -1 -1 -1 -1 -1    -1 -1 -1 -1 -1 -1 -1 -1 -1 -1 -1 -1 -1 -1 -1 -1 -1 -1 -1 -1   -1 -1 -1 -1 -1 -1 -1 -1 -1 -1 -1 -1 -1 -1 -1 -1 -1 -1 -1 -1    -1 -1 -1 -1 -1 -1 -1 -1 -1 -1 -1 -1 -1 -1 -1 -1 -1 -1 -1 -1    -1 -1 -1 -1 -1 -1 -1 -1 -1 -1 -1 -1 -1 -1 -1 -1 -1 -1 -1 -1
-1 -1 -1 -1 -1 -1 -1 -1 -1 -1 -1 -1 -1 -1 -1 -1 -1 -1 -1 -1    -1 -1 -1 -1 -1 -1 -1 -1 -1 -1 -1 -1 -1 -1 -1 -1 -1 -1 -1 -1   -1 -1 -1 -1 -1 -1 -1 -1 -1 -1 -1 -1 -1 -1 -1 -1 -1 -1 -1 -1    -1 -1 -1 -1 -1 -1 -1 -1 -1 -1 -1 -1 -1 -1 -1 -1 -1 -1 -1 -1    -1 -1 -1 -1 -1 -1 -1 -1 -1 -1 -1 -1 -1 -1 -1 -1 -1 -1 -1 -1
-1 -1 -1 -1 -1 -1 -1 -1 -1 -1 -1 -1 -1 -1 -1 -1 -1 -1 -1 -1    -1 -1 -1 -1 -1 -1 -1 -1 -1 -1 -1 -1 -1 -1 -1 -1 -1 -1 -1 -1   -1 -1 -1 -1 -1 -1 -1 -1 -1 -1 -1 -1 -1 -1 -1 -1 -1 -1 -1 -1    -1 -1 -1 -1 -1 -1 -1 -1 -1 -1 -1 -1 -1 -1 -1 -1 -1 -1 -1 -1    -1 -1 -1 -1 -1 -1 -1 -1 -1 -1 -1 -1 -1 -1 -1 -1 -1 -1 -1 -1
-1 -1 -1 -1 -1 -1 -1 -1 -1 -1 -1 -1 -1 -1 -1 -1 -1 -1 -1 -1    -1 -1 -1 -1 -1 -1 -1 -1 -1 -1 -1 -1 -1 -1 -1 -1 -1 -1 -1 -1   -1 -1 -1 -1 -1 -1 -1 -1 -1 -1 -1 -1 -1 -1 -1 -1 -1 -1 -1 -1    -1 -1 -1 -1 -1 -1 -1 -1 -1 -1 -1 -1 -1 -1 -1 -1 -1 -1 -1 -1    -1 -1 -1 -1 -1 -1 -1 -1 -1 -1 -1 -1 -1 -1 -1 -1 -1 -1 -1 -1
