3 0 0 0 0 0 0 0 0 0 0 0 0 0 0 0 0 0 0 0
2 8 -1 -1 -1 0 -1 -1 -1 -1 -1 -1 -1 7 6 -1 -1 -1 -1 -1
2 -1 -1 -1 -1 -1 -1 -1 -1 -1 -1 -1 -1 7 6 -1 -1 -1 -1 -1
2 -1 -1 -1 -1 -1 -1 -1 -1 -1 -1 -1 -1 7 6 -1 -1 -1 -1 -1
2 8 -1 -1 -1 -1 -1 -1 -1 -1 -1 -1 -1 7 6 -1 -1 -1 -1 -1
1 0 0 0 0 0 0 0 0 0 0 0 0 5 4 0 0 0 0 0
