 -1  -1  -1  -1  -1  -1  -1  -1  -1  -1  -1  -1  -1  -1  -1  -1  -1  -1  -1  -1    -1  -1  -1  -1  -1  -1  -1  -1  -1  -1  -1  -1  -1  -1  -1  -1  -1  -1  -1  -1    -1  -1  -1  -1  -1  -1  -1  -1  -1  -1  -1  -1  -1  -1  -1  -1  -1  -1  -1  -1    -1  -1  -1  -1  -1  -1  -1  -1  -1  -1  -1  -1  -1  -1  -1  -1  -1  -1  -1  -1    -1  -1  -1  -1  -1  -1  -1  -1  -1  -1  -1  -1  -1  -1  -1  -1  -1  -1  -1 100
 -1 134 134 134 134 134 134 134 134 134 134 134 134 134 134 134 134 134 134 134   134 134 134 134 134 134 134 134 134 134 134 134 134 134 134 134 134 134 134 134   134 134 134 134 134 134 134 134 134 134 134 134 134 134 134 134 134 134 134 134   134 134 134 134 134 134 134 134 134 134 134 134 134 134 134 134 134 134 134 134   134 134 134 134 134 134 134 134 134 134 134 134 134 134 134 134 134 134 134 134
 -1 134 134 134 134 134 134 134 134 134 134 134 134 134 134 134 134 134 134 134   134 134 134 134 134 134 134 134 134 134 134 134 134 134 134 134 134 134 134 134   134 134 134 134 134 134 134 134 134 134 134 134 134 134 134 134 134 134 134 134   134 134 134 134 134 134 134 134 134 134 134 134 134 134 134 134 134 134 134 134   134 134 134 134 134 134 134 134 134 134 134 134 134 134 134 134 134 134 134 134
 -1 134 134 134 134 134 134 134 134 134 134 134 134 134 134 134 134 134 134 134   134 134 134 134 134 134 134 134 134 134 134 134 134 134 134 134 134 134 134 134   134 134 134 134 134 134 134 134 134 134 134 134 134 134 134 134 134 134 134 134   134 134 134 134 134 134 134 134 134 134 134 134 134 134 134 134 134 134 134 134   134 134 134 134 134 134 134 134 134 134 134 134 134 134 134 134 134 134 134 134
 -1 134 134 134 134 134 134 134 134 134 134 134 134 134 134 134 134 134 134 134   134 134 134 134 134 134 134 134 134 134 134 134 134 134 134 134 134 134 134 134   134 134 134 134 134 134 134 134 134 134 134 134 134 134 134 134 134 134 134 134   134 134 134 134 134 134 134 134 134 134 134 134 134 134 134 134 134 134 134 134   134 134 134 134 134 134 134 134 134 134 134 134 134 134 134 134 134 134 134 134
 -1 134 134 134 134 134 134 134 134 134 134 134 134 134 134 134 134 134 134 134   134 134 134 134 134 134 134 134 134 134 134 134 134 134 134 134 134 134 134 134   134 134 134 134 134 134 134 134 134 134 134 134 134 134 134 134 134 134 134 134   134 134 134 134 134 134 134 134 134 134 134 134 134 134 134 134 134 134 134 134   134 134 134 134 134 134 134 134 134 134 134 134 134 134 134 134 134 134 134 134


 99  99  99  99  99  99  99  99  99  99  99  99  99  99  99  99  99  99  99  99    99  99  99  99  99  99  99  99  99  99  99  99  99  99  99  99  99  99  99  99    99  99  99  99  99  99  99  99  99  99  99  99  99  99  99  99  99  99  99  99    99  99  99  99  99  99  99  99  99  99  99  99  99  99  99  99  99  99  99  99    99  99  99  99  99  99  99  99  99  99  99  99  99  99  99  99  99  99  99   99
166  -1  -1  -1 141  -1  -1  -1  -1  -1  -1  -1  -1  -1  -1  -1  -1  -1  -1  -1   142  -1  -1  -1  -1  -1  -1  -1  -1  -1  -1  -1  -1  -1  -1  -1  -1  -1  -1 141    -1  -1  -1  -1  -1  -1  -1  -1  -1  -1  -1  -1  -1  -1 141  -1  -1  -1  -1  -1    -1  -1 141  -1  -1  -1  -1  -1  -1  -1  -1  -1  -1  -1  -1  -1  -1  -1  -1  -1    -1  -1  -1  -1  -1  -1  -1  -1  -1  -1  -1  -1  -1  -1  105 109 113 -1  -1   99
166  -1  -1  -1  -1  -1  -1  -1  -1  -1  -1  -1  -1 141  -1  -1  -1  -1  -1  -1    -1  -1  -1  -1  -1  -1  -1  -1  -1  -1  -1 142  -1  -1  -1  -1  -1  -1  -1  -1    -1  -1  -1  -1  -1  -1 142  -1  -1  -1  -1  -1  -1  -1  -1  -1  -1  -1  -1  -1    -1  -1  -1  -1  -1  -1  -1  -1  -1  -1  -1  -1  -1  -1  -1  -1  -1  -1  -1 141    -1  -1  -1  -1  -1  -1  -1  -1  -1  -1  -1  -1  -1  -1  106 110 114 -1  -1   99
166  -1  -1  -1  -1  -1  -1  -1  -1  -1  -1  -1  -1  -1  -1  -1  -1  -1  -1  -1    -1  -1  -1  -1  -1  -1  -1  -1 124 125  -1  -1  -1  -1  -1  -1  -1  -1 151 152    -1  -1  -1  -1  -1  -1  -1  -1  -1  -1  -1  -1  -1  -1  -1  -1  -1  -1  -1  -1    -1  -1  -1  -1  -1  -1  -1  -1  -1  -1  -1  -1  -1  -1  -1  -1  -1  -1  -1  -1    -1  -1  -1  -1  -1  -1  -1  -1  -1  -1  -1  -1  101 103 107 111 115 117 119  99
166  -1  -1  -1  -1  -1  -1  -1  -1 142  -1  -1  -1  -1  -1  -1  -1  -1  -1  -1    -1  -1  -1  -1 141  -1  -1  -1 126 127  -1  -1  -1  -1  -1  -1  -1  -1 153 154    -1  -1  -1  -1  -1  -1  -1  -1  -1  -1  -1  -1  -1  -1  -1  -1  -1  -1  -1  -1    -1  -1  -1  -1  -1  -1 142  -1  -1  -1  -1  -1  -1  -1  -1  -1  -1  -1  -1  -1    -1  -1  -1  -1  -1  -1  -1  -1  -1  -1  -1  -1  102 104 108 112 116 118 120  99
 99  99  99  99  99  99  99  99  99  99  99  99  99  99  99  99  99  99  99  99    99  99  99  99  99  99  99  99  99  99  99  99  99  99  99  99  99  99  99  99    99  99  99  99  99  99  99  99  99  99  99  99  99  99  99  99  99  99  99  99    99  99  99  99  99  99  99  99  99  99  99  99  99  99  99  99  99  99  99  99    99  99  99  99  99  99  99  99  99  99  99  99  99  99  99  99  99  99  99   99

 -1 143  -1  -1  -1  -1  -1  -1  -1  -1  -1  -1  -1  -1  -1  -1  -1  -1  -1  -1    -1  -1  -1   -1  -1  -1  -1  -1  -1  -1  -1  -1  -1  -1  -1  -1  -1  -1  -1  -1    -1  -1  -1  -1  -1  -1  -1  -1  -1  -1  -1  -1  -1  -1  -1  -1  -1  -1  -1  -1   -1  -1  -1  -1  -1  -1  -1  -1  -1  -1  -1  -1  -1  -1  -1  -1  -1  -1  -1  -1     -1  -1  -1  -1  -1  -1  -1  -1  -1  -1  -1  -1  -1  -1  121 122 123 -1  -1  -1
143  -1  -1  -1  -1  -1  -1  -1  -1  -1  -1  -1  -1  -1  -1  -1  -1  -1  -1  -1    -1  -1  -1   -1  -1  -1  -1  -1  -1  -1  -1  -1  -1  -1  -1  -1  -1  -1  -1  -1    -1  -1  -1  -1  -1  -1  -1  -1  -1  -1  -1  -1  -1  -1  -1  -1  -1  -1  -1  -1   -1  -1  -1  -1  -1  -1  -1  -1  -1 135 136 137  145 146 147 135 136 137 -1  -1     -1  -1  -1  -1  -1  -1  -1  -1  -1  -1  -1  -1  -1  -1  -1  -1  -1  -1  -1  -1
 -1  -1 124 125  -1  -1  -1  -1 135 136 137  -1  -1  -1  -1  -1  -1  -1  -1  -1   135 136 137  135 136 137  -1 124 125  -1  -1  -1  -1  -1  -1  -1  -1 151 152  -1   145 146 147 145 146 147  -1  -1  -1  -1  -1  -1  -1  -1  -1 145 146 147  -1  -1   -1  -1  -1  -1  -1  -1  -1  -1  -1 138 139 140  148 149 150 138 139 140 -1  -1     -1  -1  -1  -1  -1  -1  -1  -1  -1  -1  -1  -1  -1  -1  -1  -1  -1  -1  -1  -1
 -1  -1 126 127  -1 135 136 137 138 139 140 135 136 137 135 136 137 135 136 137   138 139 140  138 139 140  -1 126 127  -1 135 136 137  145 146 147 -1 153 154  -1   148 149 150 148 149 150 145 146 147 145 146 147 145 146 147 148 149 150 145 146  147  -1  -1  -1  -1  -1  -1  -1  -1 145 146 147  135 136 137 145 146 147 -1  -1     -1  -1  -1  -1  -1  -1  -1  -1  -1  -1  -1  -1  -1  -1  -1  -1  -1  -1  -1  -1
 -1  -1 126 127  -1 138 139 140  -1  -1  -1 138 139 140 138 139 140 138 139 140    -1  -1  -1  -1  -1  -1   -1 126 127  -1 138 139 140  148 149 150 -1 153 154  -1    -1  -1  -1  -1  -1  -1 148 149 150 148 149 150 148 149 150  -1  -1  -1 148 149  150  -1  -1  -1  -1  -1  -1  -1  -1 148 149 150  138 139 140 148 149 150 -1  -1     -1  -1  -1  -1  -1  -1  -1  -1  -1  -1  -1  -1  -1  -1  -1  -1  -1  -1  -1  -1
 -1  -1  -1  -1  -1  -1  -1  -1  -1  -1  -1  -1  -1  -1  -1  -1  -1  -1  -1  -1    -1  -1  -1  -1  -1  -1   -1  -1  -1  -1  -1  -1  -1  -1  -1  -1  -1  -1  -1  -1    -1  -1  -1  -1  -1  -1  -1  -1  -1  -1  -1  -1  -1  -1  -1  -1  -1  -1  -1  -1   -1  -1  -1  -1  -1  -1  -1  -1  -1  -1  -1  -1  -1  -1  -1  -1  -1  -1  -1  -1     -1  -1  -1  -1  -1  -1  -1  -1  -1  -1  -1  -1  -1  -1  -1  -1  -1  -1  -1  -1

 -1  -1  -1  -1  -1  -1  -1  -1  -1  -1 157  -1  -1  -1  -1  -1  -1  -1 143  -1    -1  -1  -1  -1  -1  -1 144  -1   -1  -1  -1  -1 157  -1  -1  -1  -1  -1  -1  -1     144  -1  -1  -1  -1  -1  -1  -1  -1  -1  -1  -1  -1  -1  -1  -1  -1  -1  -1  -1   -1  -1 158 161 158 161 158 161  -1 157  -1  -1  -1  -1  -1  -1  -1  -1  -1  -1    -1  -1  -1  -1  -1  -1  -1 144  -1  -1  -1  -1  -1  -1  -1  -1  -1  -1  -1  -1
 -1  -1  -1  -1  -1  -1  -1  -1  -1  -1  -1  -1  -1  -1  -1  -1  -1  -1  -1  -1    -1  -1  -1  -1  -1  -1  -1  -1   -1  -1  -1  -1  -1  -1  -1  -1  -1  -1  -1  -1      -1  -1  -1  -1  -1  -1  -1  -1  -1  -1  -1  -1  -1  -1  -1  -1  -1  -1  -1  -1   -1  -1 159 162 159 162 159 162  -1  -1  -1  -1  -1  -1  -1  -1  -1  -1  -1  -1    -1  -1  -1  -1  -1  -1  -1  -1  -1  -1  -1  -1  -1  -1  -1  -1  -1  -1  -1  -1
 -1  -1  -1  -1  -1  -1  -1  -1  -1  -1  -1  -1  -1  -1  -1  -1  -1  -1  -1  -1    -1  -1  -1  -1  -1  -1  -1  -1   -1  -1  -1  -1  -1  -1  -1  -1  -1  -1  -1  -1      -1  -1  -1  -1  -1  -1  -1  -1  -1  -1  -1  -1  -1  -1  -1  -1  -1  -1  -1  -1   -1  -1 160 163 160 163 160 163  -1  -1  -1  -1  -1  -1  -1  -1  -1  -1  -1  -1    -1  -1  -1  -1  -1  -1  -1  -1  -1  -1  -1  -1  -1  -1  -1  -1  -1  -1  -1  -1
 -1 124 125  -1  -1  -1  -1  -1  -1  -1  -1  -1  -1  -1  -1  98  -1  -1  -1  -1    -1  -1  -1  -1  -1  -1  124 125  -1  -1  -1  -1  -1  -1  57  -1 151 152  -1  -1      -1  -1  -1  -1  -1  -1  -1  98  -1  -1  -1  -1  -1  58  -1  -1  -1  -1  -1  -1   -1  -1  -1  -1  -1  -1  -1  -1  -1  -1  -1  -1  -1  98  -1  -1  -1  -1  -1  -1    -1  -1  -1  -1  -1  -1  -1  -1  -1  -1  -1  -1  -1  -1  -1  -1  -1  -1  -1  -1
 -1 126 127  -1  -1  -1  -1  -1  -1  -1  -1  -1  -1  -1  -1  -1  -1  -1  -1  -1    -1  -1  -1  -1  -1  -1  126 127  -1  -1  -1  -1  -1  -1  -1  -1 153 154  -1  -1      -1  -1  -1  -1  -1  -1  -1  -1  -1  -1  -1  -1  -1  -1  -1  -1  -1  -1  -1  -1   -1  -1  -1  -1  -1  -1  -1  -1  -1  -1  -1  -1  -1  -1  -1  -1  -1  -1  -1  -1    -1  -1  -1  -1  -1  -1  -1  -1  -1  -1  -1  -1  -1  -1  -1  -1  -1  -1  -1  -1
 -1  -1  -1  -1  -1  -1  -1  -1  -1  -1  -1  -1  -1  -1  -1  -1  -1  -1  -1  -1    -1  -1  -1  -1  -1  -1  -1  -1   -1  -1  -1  -1  -1  -1  -1  -1  -1  -1  -1  -1      -1  -1  -1  -1  -1  -1  -1  -1  -1  -1  -1  -1  -1  -1  -1  -1  -1  -1  -1  -1   -1  -1  -1  -1  -1  -1  -1  -1  -1  -1  -1  -1  -1  -1  -1  -1  -1  -1  -1  -1    -1  -1  -1  -1  -1  -1  -1  -1  -1  -1  -1  -1  -1  -1  -1  -1  -1  -1  -1  -1


 -1  -1  -1  -1  -1  -1  -1  -1  -1  -1 144  -1  -1  -1  -1  -1  -1  -1  -1  -1    -1  -1  -1  -1  -1  -1  -1  -1  -1  -1  -1  -1 144  -1  -1  -1  -1  -1  -1  -1     -1 157  -1  -1  -1  -1  -1 143  -1  -1  -1  -1  -1  -1  -1  -1  -1  -1 144  -1     -1  -1  -1  -1  -1  -1  -1  -1  -1 144  -1  -1  -1  -1  -1  -1  -1  -1  -1 143    -1  -1  -1  -1  -1  -1  -1 157  -1  -1  -1  -1  -1  -1  -1  -1  -1  -1  -1  -1
 -1  -1  -1  -1  -1  -1  -1  -1  -1  -1  -1  -1  -1  -1  -1  -1  -1  -1  -1  -1    -1  -1  -1  -1  -1  -1  -1  -1  -1  -1  -1  -1  -1  -1  -1  -1  -1  -1  -1  -1     -1  -1  -1  -1  -1  -1  -1  -1  -1  -1  -1  -1  -1  -1  -1  -1  -1  -1  -1  -1     -1  -1  -1  -1  -1  -1  -1  -1  -1  -1  -1  -1  -1  -1  -1  -1  -1  -1  -1  -1    -1  -1  -1  -1  -1  -1  -1  -1  -1  -1  -1  -1  -1  -1  -1  -1  -1  -1  -1  -1
 -1  -1 144  -1  -1  -1  -1  -1  -1  -1  -1  -1  -1  -1  -1  -1  -1  -1  -1  -1    -1  -1  -1  -1  -1  -1  -1  -1  -1  -1  -1  -1  -1  -1  -1  -1  -1  -1  -1  -1     -1  -1  -1  -1  -1  -1  -1  -1  -1  -1  -1  -1  -1  -1  -1  -1  -1  -1  -1  -1     -1  -1  -1  -1  -1  -1  -1  -1  -1  -1  -1  -1  -1  -1  -1  -1  -1  -1  -1  -1    -1  -1  -1  -1  -1  -1  -1  -1  -1  -1  -1  -1  -1  -1  -1  -1  -1  -1  -1  -1
 -1  -1  -1  -1  -1  -1  -1  -1  -1  -1  -1  -1  -1  -1  -1  -1  -1  -1  -1  -1    -1  -1  -1  -1  -1  -1  -1  -1  -1  -1  -1  -1  -1  -1  -1  -1  -1  -1  -1  -1     -1  -1  -1  -1  -1  -1  -1  -1  -1  -1  -1  -1  -1  -1  -1  -1  -1  -1  -1  -1     -1  -1  -1  -1  -1  -1  -1  -1  -1  -1  -1  -1  -1  -1  -1  -1  -1  -1  -1  -1    -1  -1  -1  -1  -1  -1  -1  -1  -1  -1  -1  -1  -1  -1  -1  -1  -1  -1  -1  -1
 -1  -1  -1  -1  -1  -1  -1 157  -1  -1  -1  -1  -1  -1  -1 157  -1  -1  -1  -1    -1  -1  -1  -1  -1  -1  -1  -1  -1  -1  -1  -1  -1  -1  -1  -1  -1  -1  -1  -1     -1  -1  -1  -1  -1  -1  -1  -1  -1  -1  -1  -1  -1  -1  -1  -1  -1  -1  -1  -1     -1  -1 158 161 158 161 158 161  -1  -1  -1  -1  -1  -1  -1  -1  -1  -1  -1  -1    -1  -1  -1  -1  -1  -1  -1  -1  -1  -1  -1  -1  -1  -1  -1  -1  -1  -1  -1  -1
 -1  -1  -1  -1  -1  -1  -1  -1  -1  -1  -1  -1  -1  -1  -1  -1  -1  -1  -1  -1    -1  -1  -1  -1  -1  -1  -1  -1  -1  -1  -1  -1  -1  -1  -1  -1  -1  -1  -1 143    143  -1  -1  -1  -1  -1  -1  -1  -1  -1  -1  -1  -1  -1 143 143  -1  -1  -1  -1     -1  -1 160 163 160 163 160 163  -1  -1  -1  -1  -1  -1  -1 143  -1  -1  -1  -1    -1  -1  -1 144  -1  -1  -1  -1  -1  -1  -1  -1  -1  -1  -1  -1  -1  -1  -1  -1
